NO ./texture/north
SO ./texture/north
WE ./texture/north
EA ./texture/north
C 225,30,0
F 220,100,126


111111111111111111111111111111
1011100000N0000011111111111111
100000000011000000000000111101
101100000111000000001000000001
110000001101010111000000000011
100000000000000011000000100011
100000000000000011010100000011
111101111111010111011110000011
111111111111111111111111111111
